0_36_52_0_0
0_36_53_0_0
0_36_54_0_0
0_37_48_0_0
0_37_49_0_0
0_37_50_0_0
0_37_51_0_0
0_37_55_0_0
0_38_45_0_0
0_38_46_0_0
0_38_47_0_0
0_38_48_0_0
0_38_55_0_0
0_39_45_0_0
0_40_45_0_0
0_41_45_0_0
0_41_56_0_0
0_42_45_0_0
0_42_56_0_0
0_43_56_0_0
0_45_56_0_0
0_45_57_0_0
0_45_58_0_0
0_45_59_0_0
0_45_60_0_0
0_45_61_0_0
0_47_45_0_0
0_47_46_0_0
0_48_45_0_0
0_48_46_0_0
0_49_46_0_0
0_50_46_0_0
0_51_46_0_0
0_52_46_0_0
0_52_47_0_0
0_52_48_0_0
0_52_55_0_0
0_52_56_0_0
0_52_57_0_0
0_52_58_0_0
0_52_59_0_0
0_52_60_0_0
0_52_61_0_0
0_53_49_0_0
0_53_50_0_0
0_53_51_0_0
0_53_55_0_0
0_54_51_0_0
0_54_55_0_0
0_55_54_0_0
0_55_55_0_0
